############################################
            ###### #                       #
# ######### ###### ###### #### #############
# ######### ###### ###### ####             #
#                  ###### #### ########## ##
# ####################### #### ########## ##
#                              ##      ## ##
# ############################### #### ## ##
# ##      ####################### #### ## ##
# ## ############################ #### ## ##
#                                      ## ##
####### ############## ################## ##
####### ############## ################## ##
####### ############## ################## ##
#                    #                     F
############################################